Otis Redding: Mr. Pitiful
William Bell: I Forgot to Be Your Lover
The Staple Singers: I'll Take You There
Isaac Hayes: Theme from Shaft
Benjamin Gibbard: The Concept
Marlon Williams: Vampire Again
Phoebe Bridgers: Motion Sickness
Fink: Cracks Appear
Lost Horizons: The Place We've Been
Galimatias: Blowback
Helado Negro: Come Be Me
Jade Bird: Good Woman
Dinner: Un-American Woman
Kasabian: Bless This Acid House
Sudan Archives: Come Meh Way
Mr Pauer: Justice
Jessica Lea Mayfield: Sorry Is Gone
Waxahatchee: Silver
Amadou & Mariam: Bofou Safou
Coast Modern: Dive
Hollie Cook: Angel Fire
Moon Boots: Keep the Faith
Great Willow: Many Things
Jolie Holland & Samantha Parton: Wildflower Blues
Jordan Rakei: Sorceress
Dan Croll: Bad Boy
DJDS: Trees on Fire (feat. Amber Mark & Marco McKinnis)
Rhye: Please
Wolf Alice: Don't Delete the Kisses
Matthew Dear: Modafinil Blues
Joey Dosik: Game Winner
Kinky: Un Peso
Jorja Smith: Beautiful Little Fools
TOKiMONSTA: Don't Call Me (feat. Yuna)
Michael McDonald: Find It in Your Heart
Cigarettes after Sex: Each Time You Fall in Love
Perfume Genius: Slip Away
Now, Now: SGL
Beach House: Chariot
Mon Laferte: Mi Buen Amor
Buyepongo: Vamos a Gozar
La Vida Bohème: Domingo
A.Chal: Perdóname
ÌFÉ: House of Love
Planetarium: Saturn
Cody ChesnuTT: Have You Heard from the Lord Today? (feat. Raphael Saadiq)
Marlene: Don't You Worry
The Drums: Blood under My Belt
Suzanne Santo (of HoneyHoney): Ghost in My Bed
Nomade Orquestra: Estrada para Camomila
Hundred Waters: Particle
Little Dragon: Strobe Light
Blood Wine or Honey: Anxious Party People
Rubén González: Melodía del Río
The Steoples: From the Otherside
Tristen: Clandestine
Iron & Wine: Call It Dreaming
New Mystics: Rebels
Arthur Verocai: Amor Na Contra Mao
Joey Bada$$: Temptation
Tei Shi: How Far
Courtney Barnett: How To Boil An Egg
Washed Out: Get Lost
Offa Rex: The Queen of Hearts
Pokey LaFarge: Must Be a Reason
Saint Etienne: Heather
Café Tacvba: Me Gusta Tu Manera
Fenech-Soler: Night Time TV
Grizzly Bear: Mourning Sound
Brazilian Girls: Pirates
James Vincent McMorrow: True Care
Ozomatli: La Bamba
Cornelius: If You're Here
Amber Mark: Lose My Cool
Alex Ebert: Broken Record
Alex Cuba: Todas Las Cabezas Están Locas
Big Wild: Empty Room (feat. Yuna)
Oumou Sangare: Mogoya
Phoenix: J-Boy
Joe Goddard: Ordinary Madness
Levi Thomas: The Fear
Ryuichi Sakamoto: Life, Life
Big Thief: Mythological Beauty
Alice Coltrane: Om Rama
The Afghan Whigs: Demon in Profile
RAC: This Song (feat. Rostam)
Cones: Echoes On
Korey Dane: Half Asleep
Harriet Brown: Cryptid
Niia: Nobody
Hazel English: Fix
Neil Frances: Dumb Love
Timothy Seth Avett as Darling: Disappointing You
Robyn Hitchcock: Autumn Sunglasses
Kenny Burrell & John Coltrane: Freight Trane
SYML: Where's My Love
Benjamin Booker: Witness (feat. Mavis Staples)
El Niño & the Southern Oscillation: Number Stations
Broken Social Scene: Halfway Home
Petit Biscuit: Sunset Lover
PWR BTTM: Answer My Text
Bay Ledges: Safe (Speak Too Soon)
Nick Hakim: Bet She Looks Like You
Sampha: (No One Knows Me) Like the Piano
King Gizzard & the Lizard Wizard: Rattlesnake
Chicano Batman: Freedom Is Free
Father John Misty: Ballad of the Dying Man
Thundercat: Friend Zone
Chuck Berry: Big Boys
Ride: Home Is a Feeling
Sean Rowe: Newton's Cradle
Future Islands: Ran
Yellow Days: Gap in the Clouds
DJ Premier X Miguel: 2 Lovin You
Fiora and Robot Koch: Let It Go By
O+S: Hold You Down
Juana Molina: Cosoco
Karriem Riggins: Bahia Dreamin'
Big Gigantic: The Little Things (feat. Angela McCluskey)
Geotic: Nav
CeCe Winans: Hey Devil! (feat. The Clark Sisters)
Fink: Boneyard
Matthew Logan Vasquez: Same
Conor Oberst: A Little Uncanny
Real Estate: Darling
Aimee Mann: Patient Zero
Sinkane: Won't Follow
Beginning of program - March 14, 2017