Eggshells - Un
The Jayhawks - This Forgotten
Delvon Lamarr Organ Trio - Inner City 
IDLES - Gr
SAULT - Wild


Akasha System - Warped S
India Jordan - Fo
Land of Talk - Weight of That We
Mourn - Call You
Petite Noir & Kingdom - 


Gabriel Teodros - If They Come For Me In The Morning... (feat. Aisha Fukus
The Beths - I’m Not Getting Ex
Fontaines D.C. - A Hero's 
Gordi - Sandw
Phoebe Bridgers - 


Deep Sea Diver - Stop Prete
Liv.e - SirLadyMake
Sibille Attar - Hu
Jake Blount - Where Did You Sleep Last 
SPECSWIZARD - 


Danny Denial - I'm Not Your Type (feat. DoNor
Baronhawk Poitier - Temperado To
Princess Nokia - G
Zebra Katz - IN 
Shamir - On M


Shabazz Palaces - Chocolate So
Bee Bee Sea - Daily
Tropea - Techni
Joensuu 1685 - Light In The Heart Of Our
Orion Sun - Ne Me Quitte Pas (Don't Leav




Joensuu 1685 - Light In The Heart Of Our







Chicano Batman - I Kn

Hollis - Heavy 
K!MMORTAL - Br
Lightning Bug - The Onely
MYXA - Ca
MAITA - Someone's Lost Their W


Minimal Violence - Ravebomb (Fire
Houses of Heaven - A Place Be
FEE LION - Blood Si
The Ninth Wave - Happy 
Rowland S. Howard - Autolumine


Smokey Brights - I Love You But
Coriky - Clean
DJ Python - ADMSDP (feat. LA Wa
Holy Esque - Reverence 
William McCarthy - Ballad for the Unemp


DJ Houseplants - Just Don't
Black Flowers Cafe 
ALTA - Figure
Daníel Hjálmtýsson - 
Lee Fields & The Expressions - Don't Gi


STRFKR - Never the
Washed Out - Too
Hazel English - Off My
Chemtrails - Frightful in the Sun
Woods - Where Do You Go When You D


Shane Tutmarc - A Brave New 
Catholic Action - There Will Always Be a 
Iceage - Lockdown 
Benjamin Gibbard - Life in Quara
Ellis - Fall 


Sólveig Matthildur - Dystopia
Sinead O'Brien - Taking On
L'Eclair - Suite 
Balkan Taksim - Z
Jesse Markin 


Tomo Nakayama - Get To Kno
Sharon Van Etten - Beaten
RINSE - Tell Me Tell Me Te
Andy Shauf - Try 
Other Lives - Los


Tres Leches - 
Lucinda Williams - Man Without a
Archers of Loaf - Raleigh Days
Steve Earle & The Dukes - Devil Put the Coal in the Ground
Throwing Muses - Dark Blue


The B-Band - Kavire Del
Liraz - Zan Bezan
Bahram - Goosht
SarrSew - Farewell, Warden

Wizard Apprentice - I Am Invisible


Dur-Dur Band -  Hayeelin
Hailu Mergia, The Walias - Lomi Tera-Tera
The Calais Sessions - Yesus
Tinariwen - Le Chant Des Fauves
Sierra Leone's Refugee All Stars - Living Like a Refugee


Floored Faces - Birdwatching
Maps - Surveil
Skating Polly - Play House
La Neve - Maximum Wage
Greys - These Things Happen


Hezza Fezza - Like Prince
Tycho - Easy
Operators - Faithless
Honeyblood - She's a Nightmare
Arre! Arre! - His-Story Moves In Circles


Dude York - Falling
Bleached - Hard to Kill
Mavis Staples - Change
Wand - Scarecrow
Seratones - Gotta Get To Know Ya



The Dream Syndicate - Black Light

Black Pumas - Colors
The Budos Band - Old Engine Oil


chong the nomad - Two Colors
Crows - Chain of Being
Kishi Bashi - F Delano
Claude Fontaine - Pretending He Was You
Alex Schaaf - Drive On


Mac DeMarco - All of Our Yesterdays
Just Mustard - Frank
MorMor - Outside

Altın Gün - Süpürgesi Yoncadan



DIÄT - W.I.G.T.D.W.M?
Outtacontroller - Trash On (Alt Version)
Fitness Womxn - Easy
Uranium Club - Grease Monkey


OCnotes - Better Days
Star Slinger - Choose Yourself
Quivers - You're Not Always On My Mind
Stef Chura - Method Man
Calexico and Iron and Wine - Father Mountain


New Age Healers - Satellite
Sol Oosel - The Dark Side of the Sun
Titus Andronicus - (I Blame) Society
Lowly - Stephen
Jamila Woods - ZORA


Oceanwires - Beware The Heartless
Charly Bliss - Capacity
Jesus & The Brides of Dracula - Turning Teeth
Lady Lamb - Even In The Tremor



Ben Zaidi - Uproar, Uproar
Orville Peck - Dead of Night
Citizen Cope - The River
Steve Earle and The Dukes - Dublin Blues
Club Night - Mute


Versing - Tethered
illuminati hotties - I Wanna Keep Yr Dog
Daniel Norgren - Let Love Run The Game
Weyes Blood - Everyday
Helado Negro - Fantasma Vaga


Tacocat - Grains of Salt
The Mountain Goats - Younger
Cass McCombs - The Great Pixley Train Robbery
Kevin Morby - No Halo
Stella Donnelly - Old Man


LEATHERS - Phantom Heart
Bellows - The Tower
Stats - Lose It
Craig Finn - Blankets
Deer Tick - Bluesboy


Filthy Friends - Last Chance County
Holiday Ghosts - Slipstream
Tiny Ruins - Olympic Girls
Girlpool - What Chaos Is Imaginary
Tallies - Eden


Emma Lee Toyoda - Planes and Cranes
Flamingods - Marigold
Better Oblivion Community Center - Dylan Thomas
Hand Habits - placeholder
King Gizzard and the Lizard Wizard - Cyboogie


Shovels & Rope - The Wire
Nilüfer Yanya - In Your Head
Sir Babygirl - Everyone Is A Bad Friend
Strand of Oaks - Weird Ways


Essam - West is my Home II
Pion - Sympacide
Please The Trees - Mind & Care
Ex Hex - Cosmic Cave
Young Scum - Wasting Time


Shana Cleveland - Face of the Sun
Queen Zee - Idle Crown
Chemtrails - Tedium's Jaws
Snapped Ankles - Rechargeable
Kero Kero Bonito - Flyway


Sol - The Kids
Piroshka - Everlastingly Yours


Martin Frawley - End of the Bar


Eyelids - It's About To Go Down
Criminal Hygiene - Hardly News
Heavy Lungs - Jealous
Ellis May - The Distance
Angelic Milk - Helluva Dr.


Red Ribbon - Your Car
Sharon Van Etten - Seventeen
Ibibio Sound Machine - Basquiat
Fruit Bats - Getting In A Van Again
Toro Y Moi - Ordinary Pleasure


Telekinesis - Set A Course
Weakened Friends - Blue Again
Doe - Heated
Generationals - Beggar In The House of Plenty
David Nance Group - Poison


Left At London - Revolution Lover
Blushing - Sunshine
Brother Ali - Sensitive
Domenique Dumont - Le soleil dans le monde
Fenster - HBW


Sloucher - Up and Down
Crooked Man - Turnaround
Amanda Palmer - Drowning In The Sound
Big Joanie - Fall Asleep
Ex:Re - Crushing


Full Toilet - Brew Christmas/All I Want For Christmas Is Dead
JD McPherson - Hey Skinny Santa!
Posh Lost - Gifts Received
Mud On My Bra - Allergic To Christmas










Art d'Ecco - Nobody's Home
Bee Bee Sea - Sonic Boomerang
EURINGER - The Medicine Does Not Control Me
Fontaines D.C. - Too Real
Gaye Su Akyol - Laziko


Y La Bamba - Mujeres
Matthew Dear - Modafinil Blues
Kikagaku Moyo - Gatherings
Briston Maroney - Under My Skin
Charles Bradley - I Feel A Change


The Dip - She Gave Me The Keys
The Twilight Sad - I/m Not Here [missing face]
Liela Moss - Wild As Fire
Metric - Dressed to Suppress
Guerilla Toss - Meteorological
Film School - Crushin'
Adia Victoria - Dope Queen Blues
Fucked Up - Dose Your Dreams


Vök - Autopilot
Teitur Magnússon - Lífsspeki
Júníus Meyvant - High Alert
Hugar - Waves (feat. Arnór Dan)
GYDA - Moonchild


Spesh - Teflon
Calvin Johnson - Kiss Me Sweetly
Tears Run Rings - Helios Heliadae
Smokey Brights - Different Windows
Spirit Award - Supreme Truth

Blue J - Hard To Know
You Said Strange - Brain
Adrianne Lenker - symbol


NAVVI - Us
Emma Ruth Rundle - Darkhorse
Muncie Girls - Bubble Bath
Kingdom (feat. North Downs)
The Midnight Revolution - Goodbye


Mark Lanegan & Duke Garwood - Save Me
Thin Lips - Gaslight Anthem (The Song Not The Band)
Mourn - Fun At The Geysers
Culture Abuse - Bee Kind To The Bugs
Fred Thomas - Good Times Are Gone Again


Laura Gibson - Tenderness
Bad Moves - One Thing
JOHN - Balfron
Erika Spring - Scars
Tunde Olaniran - Mountain


Tres Leches - I Try
Pascal Babare - Go Now
Foxing - Heartbeats
Marissa Nadler - Blue Vapor
J Mascis - See You At The Movies


Whitney Ballen - Rainier
Tomberlin - Any Other Way
Sudakistan - Two Steps Back
PURRPURR - Aldrig Som Dig
Smokescreens - Someone New


SÁVILA - Carnival
Niña Dioz - Tambalea (feat. Lido Pimienta and Ceci Bastida)
Los Blenders - Ya No Te Quiero
The Chamanas - Alas De Hierro
Los Mundos - Rompe Tu Guitarra


Kilcid Band - The Good Get Gone
Still Corners - Black Lagoon
Boy Azooga - Breakfast Epiphany
Georgia Anne Muldrow - Overload
Desert Mountain Tribe - Way Back To You


Hi Crime - Wait
Jesse Sykes & The Sweet Hereafter - Dewayne
Trevor Powers - Ache
Lala Lala - Destroyer
Petal - Better Than You


Black Belt Eagle Scout - Soft Stud
Kristin Hersh - No Shade In Shadow
Haerts - New Compassion
Holy Esque - I Am the Truth
IDLES - Colossus


Beverly Crusher - Gimmie The Power
Ovlov - Fast G
Shy Boys - Basement
BC Camplight - I'm Desperate
Chanti Darling - Wake Up The Night


Versing - Silver Dollar
Dilly Dally - I Feel Free
Bloods - Feelings
Cold Soda - Holly Leaf
Big Ups - Fear


Snuff Redux - The French Press
The Beths - Future Me Hates Me
Sink Ya Teeth - Substitutes
Wild Pink - There Is A Ledger
Trampled By Turtles - The Middle


Among Authors - Lure
Hurry - Read Between The Lines
Restorations - The Red Door
Dan Mangan - Troubled Mind
gobbinjr - November 163


Jo Passed - MDM
Death Bells - Echoes
Candi Staton - Confidence
John Parish - Sorry For Your Loss
Jim James - Throwback


Lithics - Specs
Collections of Colonies of Bees - Ruins
oso oso - gb/ol h/nf
Israel Nash - Rolling On
The Love Language - New Amsterdam


The Black Tones - Plaid Pants
Spiritualized - A Perfect Miracle
Virginia Wing - Be Released
Devon Welsh - I'll Be Your Ladder
Eternal Summers - Contenders


Dude York - Moon
The Autumn Stones - Mandatory Love
Calpurnia - City Boy
King Tuff - Raindrop Blue
Deva Mahal - Snakes


Jenn Champion - O.M.G. (I'm All Over It)
Hanssen - Subduction (Continental Version)
JusMoni - Characters (ft. WaxTheProducer)
Ezra Furman - Love You So Bad
SSION - Inherit


Chromatics - Black Walls
Mitski - Geyser
Bambara - José Tries to Leave
Blushh - Do I Look Tired?
Fontaines D.C. - Chequeless Reckless


Horse Feathers - Born in Love
Tunng - Flatland
The Qualitons - All We Can Do
Fatoumata Diawara - Negue Negue
Barrie - Tal Uno


Phono Paradiso - She Leaves A Ghost
Soft Science - Undone
Shamir - The Things You Loved
American Wrestlers - Ignoramus
Cary Brothers - Crush


Blackwater Holylight - Sunrise
Slow Riot - Burn In The City
Chatham Rise - Hummingbird
Lost Under Heaven - Bunny's Blues
Shakey Graves - Kids These Days


Sango - Speak
E - Untie Me
Tancred - Reviews
Garden City Movement - Before I Fall
GUM - The Blue Marble


Wimps - Garbage People
Hop Along - How Simple
Arthur Buck - Are You Electrified?
Okkervil River - Pulled Up The Ribbon
Pascal Babare - Native Birds


The True Loves - The Dapper Derp
Mastersystem - Notes On A Life Not Quite Lived
Simian Mobile Disco - Caught In A Wave
Mint Field - Quiero Otoño de Nuevo
Elvis Perkins - There Go The Nightmericans


Pearl Jam - Can't Deny Me
Durand Jones & The Indications - Tuck 'N' Roll
illuminati hotties - Paying Off The Happiness
Natalie Prass - Sisters
Imarhan - Ehad Wa Dagh


Neko Case - Hell-On
G Flip - About You
Melody's Echo Chamber - Breathe In, Breathe Out
Soccer Mommy - Your Dog
Unknown Mortal Orchestra - American Guilt


Damien Jurado - Over Rainbows and Ranier
Belly - Shiny One
Exitmusic - Iowa
Hilary Woods - Inhaler
Now, Now - AZ


Kung Foo Grip - Don't Go Missing
Tracey Thorn - Sister (feat. Corinne Bailey Rae)
Jason McCue - When He Drinks
Sidi Touré - BK
Linda Guilala - Primavera Negra


La Luz - Cicada
Beach House - Lemon Glow
Jeff Rosenstock - All This Useless Energy
Yuno - No Going Back
Hot Snakes - Six Wave Hold-Down


Ruler - Not Your Friend
Amen Dunes - Miki Dora
Jonathan Wilson - Over The Midnight
EMA - Moptops (Twist While The World Stops)
Wye Oak - The Louder I Call, The Faster It Runs


Parisalexa - Gardens (feat. Mista DC)
Long Neck - Elizabeth
Erik Blood - The Future Was Here (feat. Palaceer Lazaro & Stas THEE Boss)
Khruangbin - Maria También
Jorge Elbrecht - Here Lies (feat. Tamaryn)


Hibou - Junipero Love
Laura Veirs - Everybody Needs You
Shame - One Rizla
Moaning - Don't Go
Speedy Ortiz - Lucky 88


Roaming Herds of Buffalo - Winter Sun
Dr. Dog - Listening In
Geowulf - Hideaway
MIEN - Earth Moon
Moby - Mere Anarchy


Tenderfoot - Break Apart
Hollie Cook - Stay Alive
Pia Fraus - Autumn Winds
Daniel Avery - Slow Fade
Boulevards - Donezo


The Moondoggies - Easy Coming
Rolling Blackouts Coastal Fever - Mainland
Loma - Black Willow
Heartbreak Junky
Eels - The Deconstruction


Unlikely Friends - King of the Last Calls
Breckin - The Story Bridge
Elvis Perkins - There Go The Nightmericans
Naked Giants - Everybody Thinks They Know (But No One Really Knows)
I'm Kingfisher - What Good Would Loving Do Me Now?




Sufjan Stevens - Tonya Harding (in Eb Major)
Gord Downie - A Natural
Martha - The Winter Fuel Allowance Ineligibility Blues


Black Nite Crash - The Things We Do
Calexico - Voices In The Field
Ought - These 3 Things
Bette Smith - I Found Love
Camp Cope - The Opener


Alyeska - Stones
Roadkill Ghost Choir - Classics (Die Young)
Superchunk - What A Time To Be Alive
Makeness - Loud Patterns
Cut Worms - Song of the Highest Tower


Falon Sierra - Sprained Ankles
Shredders - Fly As I Dare
Nabihah Iqbal - Saw U Twice
Tús Nua - Fight!
The Luxembourg Signal - Blue Field


Ages and Ages - How It Feels
Mattiel - Not Today
King Gizzard & The Lizard Wizard - The Fourth Colour
Fever Ray - Mustn't Hurry
Gingerlys - Turtledoves



DoM - Gud Tymes
Naked Giants - The Age Of Information
Crater - Novocaine
HOLY - all these worlds are yours


Dude York - Break Up Holiday
The Ogres - Xmas Is a Bust
The Minus 5 - New Christmas Hymn
Mac McCaughan - Happy New Year (Prince Can't Die Again)
Dirty Sidewalks - It's Xmas (And Everyone Is Miserable)


Flat Worms - Pearl
Gunn-Truscinski Duo - Flood And Fire
Nilüfer Yanya - Baby Luv
Ikebe Shakedown - Brushfire
Amiina - Telegram


Nearby - Breakers

Langhorne Slim - Zombie
Oh Sees - The Static God
The Clientele - Lunar Days


Smokey Brights - Come To Terms
Lor - Aquarius
No Age - Soft Collar Fad
Until The Ribbon Breaks - Here Comes The Feeling
L7 - Dispatch From Mar-A-Lago



Typhoon - Rorschach
Alex Lahey - Every Day's The Weekend
Hey Elbow - Quest
GDJYB - That Day I Went To His Funeral
Curtis Harding - On and On
Shenandoah Davis - Orbit
Metz - Cellophane
L.A. Witch - Baby In Blue Jeans
Gordi - Heaven I Know
Bully - Feel The Same
Cock & Swan - PERG (Honing)
Haley Heynderickx - Omm Sha La La
Alice Boman - Dreams
Karl Blau - Poor The War Away
The Barr Brothers - You Would Have To Lose Your Mind
Fai Baba - Can't Stop Loving You
Högni - Komdu með
ГШ (Glintshake) - Убожество
Hórmónar - Kynsvelt
Vök - BTO
Moon Palace - Shapeshifter
Destroyer - Tinseltown Swimming in Blood
Weaves - Walkaway
Ty Segall - Alta
Sharon Jones & The Dap-Kings - Matter of Time
Stag - The Bedazzler
Holiday Ghosts - Paranoia
Madeline Kenney - Always
Florist - What I Wanted To Hold
Wilsen - Garden
Versing - Body Chamber
Lamb - Illumina
Worriers - The Possiblity
Matt Emery - Empire
Tristen - Glass Jar
Shake Some Action! - Waiting For The Sun
Pinkshinyultrablast - Find Your Saint
Jessica Lea Mayfield - Sorry Is Gone
The Mynabirds - Shouting at the Dark
Iron & Wine - Call It Dreaming
Tomo Nakayama - Fourth of Julivar's
A.D.K.O.B. - Helium
Phoebe Bridgers - Motion Sickness
Keep Shelly In Athens - Seattle
Andrew Hung - Say What You Want
Dot Comet - Shut Eye
Hiss Golden Messenger - When The Wall Comes Down
Jane Weaver - Modern Kosmology
Ghostpoet - Immigrant Boogie
Blis. - Take Me Home
New Age Healers - He Took A Bullet To Heaven
Au.Ra - Above The Triangle
Beaches - When You're Gone
Dent May - Picture On A Screen
Guided By Voices - Steppenwolf Mausoleum
Noah Gundersen - The Sound
Widowspeak - Dog
A Giant Dog - Bendover
Faith Healer - Light Of Loving
ODESZA - Late Night
Octo Octa - Fleeting Moments of Freedom (Wooo)
Lone - Mind's Eye Melody
Moses Hightower - Mjóddin
Warm Digits - Growth of Raindrops (feat. Sarah Cracknell)
Dave Depper - Your Voice On The Radio
Fotoform - I Know You're Charming
Gibraltar - Cold
Trouble - Snake Eyes
Ted Leo - You're Like Me
Ariel Pink - Time To Live
DoNormaal - Ego Slave
Sheer Mag - Meet Me In The Street
Sam Coffey & The Iron Lungs - Tough
Big Thief - Shark Smile
Lee Ranaldo - New Thing
Mhostly Ghostly - Bleed Over
Chelsea Wolfe - 16 Psyche
Oumou Sangaré - Djoukourou
Alvvays - In Undertow
Charms - Siren
Daddy Issues - Locked Out
Thunderpussy - Velvet Noose
Captain, We're Sinking - Trying Year
Mammút - The Moon Will Never Turn On Me
Songhoy Blues - Voter
Michael Nau - Good Thing
Pickwick - Light It Up (Let It Burn)
Rainer Maria - Lower Worlds
The Suburbs - Hey Muse!
Zola Jesus - Exhumed
DJ NHK Guy - MOOD
Peyote Ugly - Stranger
Ulrika Spacek - Full of Men
Beach Fossils - This Year
Shout Out Louds - Oh Oh
Lea Porcelain - A Year from Here
Briana Marela - Quit
The Pains of Being Pure At Heart - Anymore
Japanese Breakfast - Machinist
Jason Isbell and the 400 Unit - Cumberland Gap
Little Star - Linda Blair
The Drums - Heart Basel
Courtney Barnett - How To Boil An Egg
CocoRosie - Smoke 'Em Out (feat. ANOHNI)
Adult Mom - Survival
Emma Lee Toyoda - Nünü
Poliça - Still Counts (feat. Spank Rock)
Spiral Stairs - Trams (Stole My Love)
Palm - Walkie Talkie
The Black Angels - Currency
Great Grandpa - Teen Challenge
Mark Lanegan Band - Nocturne
Wavves - You're Welcome
Do Make Say Think - Bound and Boundless
Lo Tom - Overboard
Louise Burns - Storms
White Reaper - The Stack
Downtown Boys - Somos Chulas (No Somos Pendejas)
Argo Vals - T Ruum
Jens Lekman - To Know Your Mission
Chastity Belt - Different Now
Old 97's - Good With God (feat. Brandi Carlile)
Chemtrails - Deranged
The Mountain Goats - Rain In Soho
The Cairo Gang - Real Enough To Believe
Eyelids - Falling Eyes
Cende - What I Want
The Megaphonic Thrift - Interlopers
The Districts - Ordinary Day
Broken Social Scene - Halfway Home
The Entrepreneurs - Ombre
Teksti TV-666 - Silmät kiinni ja kädet ristiin
Mikko Joensuu - There used to be a darkness
GIUNGLA - Sand
My Goodness - Silver Lining
Father John Misty - Total Entertainment Forever
Low Roar - Give Me an Answer
Benjamin Booker - Witness (feat. Mavis Staples)
Waxahatchee - Silver
LAKE - Turn Around
Charly Bliss - Percolator
Goldfrapp - Anymore
BNQT - Restart
Trementina - Please, Let's Go Away
Posse - Kismet
Brother Ali - Pen to Paper
The Afghan Whigs - Demon in Profile
Molly Burch - Wrong For You
Julie Byrne - Sleepwalker
J GRGRY - Cave Birds
Froth - Romance Distractions
Ride - Charm Assault
Happyness - Falling Down
PWR BTTM - Big Beautiful Day
Andrew Joslyn - Mantra For A Struggling Artist
Lusine - Just A Cloud
Jay Som - 1 Billion Dogs
Andrew Combs - Dirty Rain
ENTRANCE - Always the Right Time
Sera Cahoone - Only One
Mac DeMarco - My Old Man
Brenda Xu - Lovely Storm
Fufanu - Sports
Monster Movie - Keep the Voices Distant
Lydia Ramsey - Show Me The Stars
Oligarkh - Tri Devi
Bernays Propaganda - Armija
Rose Elinor Dougall - Colour of Water
Minus the Bear - Invisible
Hurray for the Riff Raff - Rican Beach
Hater - Mental Haven
The Wild Reeds - Only Songs
LOYAL - Moving As One
Širom - Trilogija
Persons From Porlock - Bad FanFiction
The Jack Wood - Devilishly
The Ills - 4:17
Haiku Garden - Rosetta
The Courtneys - Silver Velvet
Spaceface - Sun Kids
The Proper Ornaments - Back Pages
Cory Hanson - Replica
Priests - Nothing Feels Natural
Weirdo Machine - Something Inside
Hiccup - Teasin'
The Olympians - Sirens of Jupiter
Diet Cig - Tummy Ache
Lady Wray - Do It Again
Mega Bog - London
The Holy - Ramses The Evil Brother
Tuomo & Markus - Over the Rooftops
Emel - Ensen Dhaif
Chuck Prophet - Bobby Fuller Died For Your Sins
Shelby Earl - The Man Who Made Himself A Name
Moon Duo - Creepin'
The Besnard Lakes - Laura Lee
Childish Gambino - Have Some Love
JFDR - Wires
Rudy Willingham - Why?
Angelic Milk - Rebel Black
Luxury Death - Radiator Face
Slowdive - Star Roving
Matt Pond PA - Louisville
The Black Clouds - Vice (feat. Mark Arm and Jack Endino)
Run the Jewels - Talk To Me
Little Scream - People
Úlfur Eldjárn - Hands Up In The Air
The Radio Dept. - Occupied
Aan - All You Have to Say
Laura Marling - Soothing
Strand of Oaks - Radio Kids
Rolling Blackouts Coastal Fever - Julie's Place
Springtime Carnivore - Double Infinity
SISTERS - Buck
Little Children - (we used to feel) Higher
La Sera - Queens
Desperate Journalist - Hollow
Chemtrails - Aeons
Figg - A Case Study In Plagiarism
Gringo Star - Get Closer
Real Numbers - Falling Out
Split Single - Untry Love
Ablebody - Backseat Heart
Headwaves - Mama
Weyes Blood - Used to Be
Hiss Golden Messenger - Biloxi
TZECHAR - Bot
The Veils - Swimming with the Crocodiles
The Woggles - Santa Is Coming (Ho, Ho, Ho)
Glow Kit - Christmas Daze
Jeff Hershey and the Heartbeats - Santa Claus Is A Monster
BloodNog - Samantha Crain
Gruff Rhys - Post Apocalypse Christmas
Dude York - Black Jack
Menace Beach - Maybe We'll Drown
Doubles - Plant
Kristin Hersh - Soma Gone Slapstick
Kindling - Blinding Wave
Klunks - Vanersom
Sonny Knight & The Lakers - It Had To Change
Robyn Hitchcock & Emma Swift - Life Is Change
Michael Mayer - Mind Games (ft. Ed Macfarlane)
Acid Arab - Gul l'Abi (feat. A-WA)
Kingdom of the Holy Sun - Flown Away
Cherry Glazerr - Told You I'd Be With The Guys
The Pooches - Another Evening, Another Town
Pond - Sweep Me Off My Feet
Ty Segall - Orange Color Queen
STRFKR - Open Your Eyes
Sad13 - Less Than 2
Swampmeat - Brand New Cadillac
Bread & Butter - Desperation
Shana Falana - Cool Kids
Golden Gardens - Extrasolar Heartbeat
Moby & The Void Pacific Choir - Hey! Hey!
Kate Tempest - Don't Fall In
Terry Malts - Seen Everything
A Tribe Called Red - Virus (feat. Saul Williams & Black Bear)
Tres Leches - Get Off
Van William - Revolution (feat. First Aid Kit)
Honeyblood - Ready for the Magic
Cloud Nothings - Modern Act
Hope Sandoval & The Warm Inventions - Let Me Get There (feat. Kurt Vile)
Andy Svarthol - Ofbirta
aYia - Water Plant
WESEN - Beachboys
SUÐ - Plastgea
Singapore Sling - Let It Roll, Let It Rise
Elia - Libertad, Cultura, Fe
Los Crveles - Desastre
Ságan - Oceánico
Little Jesus - La Magia
Mateo Kingman - Sendero Del Monte
Chris Staples - Golden Age
Temples - Certainty
Cass McCombs - Opposite House
El Perro Del Mar - KoKoro
PWR BTTM - New Hampshire
Hobosexual - VHS or Sharon Stone
Sharon Jones & the Dap-Kings - I'm Still Here
Midnight Faces - Blue Haze
decker. - The Holy Ghost
Geowulf - Saltwater
Manatee Commune - Be Still (feat. Marina Price)
Flock of Dimes - Minor Justice
Teenage Fanclub - Hold On
Hoops - Cool 2
beGun - Yoko
Anomie Belle - Lovers
My bubba - Charm
Allah-Las - Could Be You
American Wrestlers - Give Up
Cymbals Eat Guitars - Wish
Math and Physics Club - Coastal California, 1985
Morgan Delt - Some Sunsick Day
Kestrels - No Alternative
Goat - Try My Robe
Tom Brosseau - You Can't Stop
Ever So Android - Pretty Teeth
Hotels - Linnette
Kweku Collins - The Outsiders
Sam Vicari - Contact High
Stephen Steinbrink - Impossible Hand
FKL - Elliott
John K. Samson - Postdoc Blues
Arbor Labor Union - Mr. Birdsong
Drive-By Truckers - Surrender Under Protest
The Tallest Man on Earth - Rivers
Ages and Ages - They Want More
Middle Kids - Edge of Town
LVL UP - Pain
Beach Slang - Punks in a Disco Bar
Mitski - Your Best American Girl
Explone - Born at the Wrong Time
Petite League - French New York
Field Mouse - The Order Of Things
Yeesh - Limbo District
Russian Circles - Mota
Laura Gibson - The Cause
Preoccupations - Anxiety
Flyying Colours – It's Tomorrow Now
Angel Olsen - Shut Up Kiss Me
Jagwar Ma - O B 1
Twin River – Knife
Alice Bag - Programmed
Pixies – Um Chagga Lagga
Crocodiles - Telepathic Lover
Daniel G. Harmann – Hesitations
Hanssen - We Went Too Far Forward
Martha - Goldman's Detective Agency
Júníus Meyvant - Beat Silent Need
Holy Fuck - Neon Dad
Nite-Funk - Let Me Be Me
Hot Hot Heat – Kid Who Stays In The Picture
Rogue Wave – California Bride
Pinegrove – Aphasia
DMA's – Timeless
The Amazing – Ambulance
Versing – Early Spring
The Parrots – Jame Gumb
The Big Pink – Hightimes
Nite Jewel – You Now
CC Dust – Never Going To Die
VHS – Wheelchair
Outer Spaces – Words
Let's Eat Grandma – Deep Six Textbook
Quantic Presenta Flowering Inferno - A Life Worth Living (feat. U-Roy & Alice Russell)
Still Parade – Chamber
The Ghost Ease - Gemini Rise
Speedy Ortiz - Death Note
Thee Oh Sees - Plastic Plant
The Strokes - OBLIVIUS
Grant-Lee Phillips - Rolling Pin
Fly Moon Royalty - Grown Man
Big Deal - Say Yes
Hammock - Everything and Nothing
Caveman - Never Going Back
Psychic Ills - I Don't Mind
SassyBlack - Comicon
Alex Anwandter - Siempre Es Viernes En Mi Corazón
The Spook School - David Bowie Songs
Thalia Zedek Band - All I Need
Mykki Blanco - High School Never Ends
Draze - The Hood Ain't The Same
Bombino - Akhar Zaman (This Moment)
Mountains and Rainbows - See How They Run
PAWS - No Grace
The Sun Days - Don't Need To Be Them
David Bazan - Both Hands (Over My Eyes)
LUH - Beneath the Concrete
Twin Peaks - Walk to the One You Love
Goodbye Heart - Lives On Lives (Radio Edit)
Lisa Prank - Starting Again
Ghosts I've Met - Songbirds
Heron Oblivion - Your Hollows
Daniel Wilson - Wedding Daze
Faye - Ancient Bones
Beth Orton - 1973
Kris Orlowski - Enough
Tourist - To Have You Back
The Coathangers - Make It Right
Adia Victoria - Dead Eyes
A Giant Dog - Sleep When Dead
Erik Blood - Quiet
Desert Mountain Tribe - Feel the Light
King Gizzard & The Lizard Wizard - Gamma Knife
Nothing - Vertigo Flowers
Marissa Nadler - Janie In Love
Manatee Commune - Clay feat. Marina Price
SWMRS - Drive North
TEEN - Tokyo
Chain of Flowers - Death's Got a Hold on Me
Carter Tanton - Twentynine Palms
Acapulco Lips - Awkward Waltz
Muncie Girls - Balloon
Black Mountain - Mothers Of The Sun
Africaine 808 - The Awakening
No Zu - Body2body
Fauna Shade - No Nostalgia
Woods - Sun City Creeps
Sunflower Bean - I Was Home
Prism Tats - Pacifist Masochist
Aesop Rock - Rings
Tangerine - Sunset
Iggy Pop - Break Into Your Heart
Charles Bradley - Change For The World
The Callas - It's Sunday I'm Bleeding
Amber Arcades - Right Now
The Posies - Unlikely Places
Vök - Waiting
Gangly - Fuck with Someone Else
View - Lace
Farao - TIAF
Radiation City - Juicy
onDeadWaves - California
The Jayhawks - Quiet Corners & Empty Spaces
Kevin Morby - I Have Been to the Mountain
Kyle Craft - Pentecost
Wild Powwers - Party Song
A.D.K.O.B. - Lung Capacity
Death Index - Dream Machine
Lust for Youth - Stardom
Coldair - Pretty Mind
STRFKR - Never Ever
Jessy Lanza - It Means I love You
PJ Harvey - The Wheel
Mark McGuire - The Undying Stars
Bleached - Keep on Keepin' On
Fruit Bats - From A Soon To Be Ghost Town
Cullen Omori - Sour Silk
Wild Nothing - TV Queen
School of Seven Bells - Open Your Eyes
Frightened Rabbit - Get Out
Naked Giants - Easy Eating
Beach Skulls - Santa Fe
Eagulls - Skipping
You Won't - Ya Ya Ya
Coast Modern - Hollow Life
OCnotes - Hum Drum Killas
Pinkshinyultrablast - The Cherry Pit
Samaris - Wanted 2 Say
Hippo Campus - South
Foxing - Night Channels
The Cave Singers - That's Why
Ringo Deathstarr - Stare At The Sun
The Thermals - Hey You
Dr. Dog - Bring My Baby Back
Daughter - New Ways
Tacocat - I Hate the Weekend
Shearwater - Quiet Americans
Ex Magician - Job Done
TRAAMS - Costner
Working for a Nuclear Free City - Bottle Rocket
Damien Jurado - Exit 353
Crater - Habits Die Slow
Mr. Silla - Holding On
Charlie Hilton - Pony
Nevermen - Mr. Mistake
Night Beats - Sunday Mourning
Bob Mould - Voices in My Head
Yeasayer - I Am Chemistry
Nadia Reid - Seasons Change
Kyson - You
La Luz - You Disappear
Kite Base - Miracle Waves
Hinds - Chili Town
DIIV - Bent (Roi's Song)
Born Ruffians - We Made It
Deep Sea Diver - Secrets
Úlfur Eldjárn - Poyekhali!
I Don't Cares - King of America
The Orange Humble Band - If That's What You Want
Nicola Cruz - Colibria
M. Ward - Girl from Conejo Valley
Lucius - Born Again Teen
Pinemen - That Certain Flavor
Nada Surf - Believe You're Mine
GEMS - w/o u
Pillar Point - Part Time Love
Soldiers Of Fortune (feat. Stephen Malkmus) - Campus Swagger
Sulk - Black Infinity (Upside Down)
Blank Realm - Palace of Love
Cheatahs - Su-Pra
The Foghorns - Ain't I a Man
Thunderbitch - Eastside Party
The Parlor - The Surgeon's Knife
DJ Béeso - (-.-)
Lymbyc Systym - Generated Bodies
Sir Coyler & His Asthmatic Band - Christmas Asthma Attack
The Dumps - Pokey The Toxic Tannenbaum
Dead Hot - Santa Claus Is Coming In Gas Form
The Tacoma Four - Christmas Is A Drag
Thee Fine Lines - I'm Givin' You the Blues (For Christmas)
Battleme - Shake Shake
Ra Ra Riot - Water
Quilt - Eliot St.
The Besnard Lakes - Golden Lion
Sun Club - Tropicoller Lease
Benjamin Verdoes - Highly Emotional
Eleanor Friedberger - False Alphabet City
Beliefs - Leaper
Merchandise feat. Dum Dum Girls - Red Sun
Danny Newcomb & The Sugar Makers - Known World
Salad Boys - No Taste Bomber
All Them Witches - Talisman
Chants Featuring Mereki - Gossamer
Midday Veil - Babel
Lemolo - Hold Light
Dilly Dally - The Touch
Martin Courtney - Northern Highway
Futurebirds - Deadbeat Hits
The Gods Themselves - Tangerines
Fast Romantics - Julia
Sudakistan - Concrete Jungle
The Foetals - Malted
MASZER - Fata Mirage
Beach Slang - Young And Alive
Mercury Rev - The Queen of Swans
Royal Headache - Carolina
Worriers - They / Them / Theirs
Æla - Your Head Is My Ground
GusGus - Obnoxiously Sexual
Emmsjé Gauti - Strákarnir
East of My Youth - Only Lover
Fruit Juice - Haunted
The Dead Weather - I Feel Love (Every Million Miles)
Beat Connection - So Good
Lou Barlow - Redeemed
Small Black - Boys Life
Ms. John Soda - Hero Whales
Søren Juul - Ambitions
Ever So Android - Moment
Hamilton Leithauser & Paul Maroon - My Reward
John Grant - Disappointing
Gospel Machine - Just Call Me
Cold Beat - Am I Dust
Seapony - A Place We Can Go
The Eagle Rock Gospel Singers - Little Light
Israel Nash - LA Lately
Tijuana Panthers - Set Forth
GO!ZILLA - Pollution
Childbirth - Nasty Grrls
Potty Mouth - Creeper Weed
Wild Ones - Dim The Lights
Bob Moses - Too Much Is Never Enough
METZ - Acetate
Dasha Rush - Abandoned Beauties and Beasts
Gilligan Moss - Choreograph
Sean Pierce - The Visitor
Mike Gervais - Lost (Sone Remix)
Bardo:Basho - From Nothing
Josef Gaard - Obsidian Falls (Archivist Remix)
Fernando - Save Me
NE-HI - Drag
Broen - Iris
T. Hardy Morris - My Me
Communions - Forget It's a Dream
Wimps - Take It As It Comes
Gibraltar - Snakes!
The Mynabirds - Wildfire
Pinkshinyultrablast - Kiddy Pool Dreams
Andy Shauf - You're Out Wasting
GO!ZILLA - Pollution
Silver Torches - Woman In Rust
Coals - Weightless
Kevin Morby - Moonshiner
Plastic Pinks - Livin' On The Coast
Titus Andronicus - Fired Up
Golden Gardens - Mirror of Silver
Drinks - Laying Down Rock
Noah Gundersen - Jealous Love
Menace Beach - Super Transporterreum
Swervedriver - Winter Depths
Strange Wilds - Pronoia
ScotDrakula - Shazon
Ezra Furman - Restless Year
Vök - If I Was
Veruca Salt - Laughing In The Sugar Bowl
Shana Cleveland & The Sandcastles - Holy Rollers
Sharon Van Etten - Just Like Blood
Ultimate Painting - (I've Got) The Sanctioned Blues
Gwenno - Patriarchaeth
Froth - Turn It Off
Destroyer - Dream Lover
Fuzz - Pollinate
Holy Esque - Fade
Diane Coffee - Mayflower
Mike Krol - This Is the News
Prom Queen - Black Magic
The Cairo Gang - Be What You Are
The Space Merchants - Mainline the Sun
EZTV - Bury Your Heart
Jaill - Getaway
Telekinesis - In a Future World
Widowspeak - All Yours
Small Feet - All And Everyone
Girls Names - Reticence
Kid Wave - Wonderlust
Ghost Pains - Arboretum
Weed - Stay in the Summer
Lightouts - More Than Ever
MOURN - Gertrudis, Get Through This!
Du Blonde - Black Flag
Black Whales - The Warm Parade
The Heavenly States - The Specialist
Júníus Meyvant - Hailslide
Hippo Campus - Suicide Saturday
Saun & Starr - Gonna Make Time
Hibou - Dissolve
Toro y Moi - Empty Nesters
Vaadat Charigim - Ein Li Makom
Fufanu - Will We Last
Waxahatchee - Under a Rock
The Drums - I Can't Pretend
Dust Moth - Casual Friends
Holly Miranda - Mark My Words
Jimmy Somerville - Freak
Baby Dee - I Am A Stick
Róisín Murphy - Gone Fishing
Timbre Barons - Automatic
Eternal Summers - Together Or Alone
angelic milk - IDK How
PINS - Too Little Too Late
The Electric Peanut Butter Company - Beer Good
Unknown Mortal Orchestra - Multi-Love
Calexico - Falling From the Sky
Mac McCaughan - Lost Again
Lady Lamb - Billions of Eyes
TORRES - Sprinter
Ivan & Alyosha - Bury Me Deep
Snuff Redux - Disintegrate the Days
The Flavr Blue - Feathers
Father John Misty - Chateau Lobby #4 (In C for Two Virgins)
Shabazz Palaces - Forerunner Foray
Rose Windows - Glory, Glory
Thee Oh Sees - Web
Crocodiles - Crybaby Demon
Novella - Land Gone
Speedy Ortiz - The Graduate
Sleater-Kinney - Surface Envy
Hop Along - Waitress
Warm Soda - Cryin For A Love
Jacco Gardner - Find Yourself
Miami Horror - Real Slow
EYELIDS - Seagulls Into Submission
Alabama Shakes - Don't Wanna Fight
DMA's - Laced
Sarah Bethe Nelson - Start Somewhere
Wolf Alice - Moaning Lisa Smile
Soft Sleep - Unravel
Lord Huron - Fool For Love
The Tallest Man on Earth - Sagres
Nadine Shah - Fool
Chromatics - I Can Never Be Myself When You're Around
Solvents - Reeling Out
POW! - Liquid Daydream
Rocky Votolato - The Hereafter
Bouquet - Come To Your House
79rs Gang - Drama
Sun Breaks - Turnstile
Mikal Cronin - Made My Mind Up
American Wrestlers - Kelly
Nic Hessler - Expel Me
Sufjan Stevens - Should Have Known Better
Mommy Long Legs - Life Rips
Wishyunu - Photoplay
Lilac - Secrets
Jackson Boone - The Dolphin Turned Into A Cat
IG88 featuring Jenni Potts - Submerged
St. Kilda - September
Pinkshinyultrablast - Holy Forest
Kate Tempest - Lonely Daze
Surf City - Spec City
Jessica Pratt - Back, Baby
Brandi Carlile - Mainstream Kid
Two Gallants - Incidental
Father John Misty - Bored In The USA
Sóley - Ævintýr
JEFF the Brotherhood - Black Cherry Pie
The Fascination Movement - The Ones You Love
Ivan & Alyosha - All This Wandering Around
Duke Evers - Lions
Zola Jesus - Compass
Ephrata - Where Have You Gone?
Dreamsalon - Soft Stab
Ghosts I've Met - The Shape of Space
Sallie Ford - Oregon
Public Service Broadcasting - Go!
Les Sins - Bother
Zebra Hunt - Half Right
THEESatisfaction - EarthEE
Ryley Walker - Primrose Green
Made Violent - Two Tone Hair
Doomtree - Gray Duck
The Helio Sequence - Stoic Resemblance
Other Lives - Reconfiguration
WATERS - Stupid Games
Bonnie & The BANG BANG - Every New Love
The Sidekicks - Deer
Kingdom of the Holy Sun - Getting Higher
The Grizzled Mighty - Chantael
The Districts - 4th and Roebling
Nikhil P. Yerawadekar & Low Mentality - Reel It In
The Go! Team - The Scene Between
Bread & Butter - Shoot My Mouth Off
JD McPherson - Let The Good Times Roll
Redtenbacher's Funkestra - Baby Fat
Chimurenga Renaissance - HomieZ (feat. Outspoken)
Viet Cong - Silhouettes
Chastity Belt - Time to Go Home
The Mountain Goats - The Legend of Chavo Guerrero
Matthew E. White - Rock & Roll Is Cold
Duke Garwood - Heavy Love
Courtney Barnett - Pedestrian At Best
Strange Wilds - Standing
King Gizzard & The Lizard Wizard - I'm In Your Mind
Au.Ra - Pyramid
Is Tropical - Crawl
Doldrums - HOTFOOT
NAVVI - Stay
Flight Facilities - Two Bodies feat. Emma Louise
Objekt - Ratchet
Garden City Movement - Entertainment
Stag - She + Me
The Weather - 1983
Ultimate Painting - Central Park Blues
Deerhoof - Paradise Girls
Cult of Youth - God's Garden
Yellerkin - Tools
Planes on Paper - Iron Boat
Lowhitey - Zorza
Korallreven - Second Comin'
Clark - Winter Linn
MOURN - Gertrudis, Get Through This!
MICHAELBRAILEY - I Lose Myself
The Shivas - Stalking Legs
Melody's Echo Chamber - Shirim
Restorations - Separate Songs
Mark Kozelek & Jimmy LaValle - What Happened to My Brother
The Twilight Sad - Last January
Sleater‐Kinney - Bury Our Friends
FF - Caught In A Dream
Will Butler - Take My Side
Mourn - Dark Issues
Flake Music - Spanway Hits
Happy Fangs - All I Want for Christmas Is Halloween
Girl Trouble - Letter to Santa
The Student Teachers - Christmas Weather
Voltaire - Comin' Out for Christmas
The Hulls - Christmas Time On the Picket Line
Murder Vibes - Not Alone Tonight
Museum of Love - The Who's Who of Who Cares
Smokey Brights - If I Can't Change Your Mind
Springtime Carnivore - Sun Went Black
Hookworms - Radio Tokyo
